1111111111111111111111111111111111
1E0000000000000C00000C000000000001
1010010100100000101001000000010101
1010010010101010001001000000010101
1P0000000C00C0000000000000000000C1
1000011110000000000000111000111001
111000000011111100000C000110000001
10000111000000000C1000000000000001
1000000000000001111111111111C00001
1000000000000000000000000000000001
100C000100000000C00000000000000001
1111111111111111111111111111111111